11 13
1 2
// ^ change to 1
WWWWWWWWWWWWW
W     W     W
W WWW W WWW W
W W       W W
W WWWWWWW WWW
W   W   W   W
WWW W WWW   W
W     W   W W
W WWWWW W WWW
W       W   W
WWWWWWWWWWWWW